a/DT stimulus/NN is/VBZ a/DT event/NN in/IN the/DT real/JJ world/NN that/WDT trigger/VB the/DT sensor/NN ./. <EOS>/<EOS>	stimulus := event in real world ^ E trigger . ( sensor ) <EOS>
integument/NN is/VBZ the/DT surface/NN structure/NN that/WDT is/VBZ the/DT outer/JJ protective/JJ covering/NN of/IN the/DT body/NN ./. <EOS>/<EOS>	integument := surface structure ^ outer protective covering of body <EOS>
a/DT sensing/VBG device/NN is/VBZ a/DT device/NN that/WDT implement/VB sensing/VBG ./. <EOS>/<EOS>	sensing device := device ^ E implement . ( sensing ) <EOS>
the/DT sensor/NN datum/NN sheet/NN is/VBZ a/DT object/NN that/WDT record/VB property/NN of/IN a/DT sensor/NN ./. <EOS>/<EOS>	sensor datum sheet := object ^ E record . ( property of sensor ) <EOS>
a/DT direct/JJ ossification/NN is/VBZ a/DT ossification/NN that/WDT do/VBZ not/RB require/VB the/DT replacement/NN of/IN pre-existing/JJ tissue/NN ./. <EOS>/<EOS>	direct ossification := ossification ^ ! E require . ( replacement of pre-existing tissue ) <EOS>
a/DT solid/JJ compound/NN organ/NN is/VBZ a/DT compound/NN organ/NN that/WDT do/VBZ not/RB contain/VB macroscopic/JJ anatomical/JJ space/NN ./. <EOS>/<EOS>	solid compound organ := compound organ ^ ! E contain . ( macroscopic anatomical space ) <EOS>
a/DT vector/NN is/VBZ a/DT organism/NN that/WDT carry/VB or/CC transmit/VB a/DT pathogen/NN ./. <EOS>/<EOS>	vector := organism ^ E ( carry U transmit ) . ( pathogen ) <EOS>
a/DT rock/NN dassie/NN is/VBZ a/DT animal/NN that/WDT eat/VBP grass/NN and/CC broad-leafed/JJ plant/NN ./. <EOS>/<EOS>	rock dassie := animal ^ E eat . ( grass ) ^ E eat . ( broad-leafed plant ) <EOS>
lion/NN are/VBP animal/NN that/WDT eat/VBP only/RB herbivore/NN ./. <EOS>/<EOS>	lion := animal ^ A eat . ( herbivore ) <EOS>
caprina/NN pizza/NN have/VB a/DT very/RB high-calorie/JJ content/NN ./. <EOS>/<EOS>	caprina pizza := E have content . ( very high-calorie content ) <EOS>
a/DT interesting/JJ pizza/NN is/VBZ a/DT pizza/NN that/WDT have/VB at/IN least/JJS NUM/CD topping/NN ./. <EOS>/<EOS>	interesting pizza := pizza ^ >= NUM have topping . ( topping ) <EOS>
spicy/NN topping/VBG is/VBZ any/DT topping/VBG that/DT have/VB a/DT hot/JJ spiciness/NN ./. <EOS>/<EOS>	spicy topping := topping ^ E have spiciness . ( hot spiciness ) <EOS>
a/DT survival/NN property/NN is/VBZ a/DT identifiable/JJ characteristic/NN that/WDT represent/VB the/DT extent/NN of/IN the/DT sensor/NN useful/JJ life/NN ./. <EOS>/<EOS>	survival property := identifiable characteristic ^ E represent . ( extent of sensor useful life ) <EOS>
a/DT device/NN is/VBZ a/DT physical/JJ piece/NN of/IN technology/NN ./. <EOS>/<EOS>	device := physical piece of technology <EOS>
a/DT device/NN is/VBZ a/DT system/NN in/IN a/DT box/NN ./. <EOS>/<EOS>	device := system in box <EOS>
a/DT feature/NN is/VBZ a/DT abstraction/NN of/IN real/JJ world/NN phenomenon/NN ./. <EOS>/<EOS>	feature := abstraction of real world phenomenon <EOS>
organism/NN subdivision/NN is/VBZ a/DT anatomical/JJ structure/NN that/WDT is/VBZ a/DT primary/JJ subdivision/NN of/IN whole/JJ organism/NN ./. <EOS>/<EOS>	organism subdivision := anatomical structure ^ primary subdivision of whole organism <EOS>
vehicle/NN are/VBP non-living/JJ means/NN of/IN transportation/NN ./. <EOS>/<EOS>	vehicle := non-living means of transportation <EOS>
a/DT observation/NN value/NN is/VBZ the/DT value/NN of/IN the/DT result/NN of/IN a/DT observation/NN ./. <EOS>/<EOS>	observation value := value of result of observation <EOS>
datum/NN are/VBP fact/NN that/WDT result/VBP from/IN measurement/NN or/CC observation/NN ./. <EOS>/<EOS>	datum := fact ^ E result from . ( measurement U observation ) <EOS>
tree/NN are/VBP a/DT type/NN of/IN plant/NN ./. <EOS>/<EOS>	tree := plant <EOS>
frutti/NN di/FW mare/NN typically/RB lack/VB cheese/NN ./. <EOS>/<EOS>	frutti di mare := E lack . ( cheese ) <EOS>
a/DT non-mineralized/JJ hyaline/NN cartilage/NN tissue/NN is/VBZ a/DT hyaline/NN cartilage/NN tissue/NN that/WDT is/VBZ not/RB mineralized/VBN ./. <EOS>/<EOS>	non-mineralized hyaline cartilage tissue := hyaline cartilage tissue ^ ! mineralized <EOS>
a/DT meaty/JJ pizza/NN is/VBZ any/DT pizza/NN that/WDT have/VB at/IN least/JJS NUM/CD topping/VBG of/IN meat/NN ./. <EOS>/<EOS>	meaty pizza := pizza ^ >= NUM have topping . ( meat ) <EOS>
a/DT property/NN is/VBZ a/DT observable/JJ quality/NN of/IN a/DT event/NN or/CC object/NN ./. <EOS>/<EOS>	property := observable quality of event U observable quality of object <EOS>
herbivore/NN are/VBP exactly/RB those/DT animal/NN that/WDT eat/VBP only/RB plant/NN or/CC part/NN of/IN plant/NN ./. <EOS>/<EOS>	herbivore := animal ^ A eat . ( plant U E part of . ( plant ) ) <EOS>
a/DT gonochoristic/JJ organism/NN is/VBZ a/DT multi-cellular/JJ organism/NN that/WDT have/VB male/JJ and/CC female/JJ sex/NN ./. <EOS>/<EOS>	gonochoristic organism := multi-cellular organism ^ E have sex . ( male sex ) ^ E have sex . ( female sex ) <EOS>
carnivore/NN are/VBP exactly/RB those/DT animal/NN that/WDT eat/VBP also/RB animal/NN ./. <EOS>/<EOS>	carnivore := animal ^ E eat . ( animal ) <EOS>
a/DT american/JJ hot/JJ pizza/NN is/VBZ a/DT type/NN of/IN american/JJ pizza/NN that/WDT have/VB jalapeno/JJ pepper/NN on/IN it/PRP ./. <EOS>/<EOS>	american hot pizza := american pizza ^ E have on . ( jalapeno pepper ) <EOS>
a/DT output/NN is/VBZ any/DT information/NN that/WDT is/VBZ reported/VBN from/IN a/DT process/NN ./. <EOS>/<EOS>	output := information ^ E reported from . ( process ) <EOS>
a/DT cell/NN space/NN is/VBZ a/DT anatomical/JJ space/NN that/WDT is/VBZ part/NN of/IN a/DT cell/NN ./. <EOS>/<EOS>	cell space := anatomical space ^ E part of . ( cell ) <EOS>
a/DT male/JJ organism/NN is/VBZ a/DT gonochoristic/JJ organism/NN that/WDT can/MD produce/VB male/JJ gamete/NN ./. <EOS>/<EOS>	male organism := gonochoristic organism ^ >= 0 produce . ( male gamete ) <EOS>
giraffe/NN are/VBP herbivore/NN ,/, and/CC they/PRP eat/VBP only/RB leaf/NN ./. <EOS>/<EOS>	giraffe := herbivore ^ A eat . ( leaf ) <EOS>
a/DT american/JJ pizza/NN is/VBZ a/DT pizza/NN that/WDT have/VB topping/NN of/IN pepperoni/NN ,/, mozzarella/NN and/CC tomato/NN ./. <EOS>/<EOS>	american pizza := pizza ^ E have topping . ( pepperoni ) ^ E have topping . ( mozzarella ) ^ E have topping . ( tomato ) <EOS>
a/DT sensor/NN is/VBZ any/DT entity/NN that/WDT can/MD follow/VB a/DT sensing/VBG method/NN ./. <EOS>/<EOS>	sensor := any entity ^ >= 0 follow . ( sensing method ) <EOS>
anal/JJ fin/NN lepidotrichium/NN is/VBZ a/DT lepidotrichium/NN that/WDT is/VBZ part/NN of/IN the/DT anal/JJ fin/NN skeleton/NN ./. <EOS>/<EOS>	anal fin lepidotrichium := lepidotrichium ^ E part of . ( anal fin skeleton ) <EOS>
caudal/JJ fin/NN lepidotrichium/NN is/VBZ a/DT lepidotrichium/NN that/WDT is/VBZ part/NN of/IN the/DT caudal/JJ fin/NN skeleton/NN ./. <EOS>/<EOS>	caudal fin lepidotrichium := lepidotrichium ^ E part of . ( caudal fin skeleton ) <EOS>
axial/JJ ossicle/NN is/VBZ a/DT ossicle/NN that/WDT is/VBZ part/NN of/IN the/DT axial/JJ skeleton/NN ./. <EOS>/<EOS>	axial ossicle := ossicle ^ E part of . ( axial skeleton ) <EOS>
craniofacial/JJ skeleton/NN is/VBZ a/DT cranial/JJ skeleton/NN derived/VBN from/IN neural/JJ crest/NN cell/NN ./. <EOS>/<EOS>	craniofacial skeleton := cranial skeleton ^ E derived from . ( neural crest cell ) <EOS>
branch/NN are/VBP part/NN of/IN tree/NN ./. <EOS>/<EOS>	branch := E part of . ( tree ) <EOS>
leaf/NN are/VBP part/NN of/IN branch/NN ./. <EOS>/<EOS>	leaf := E part of . ( branch ) <EOS>
pectoral/JJ fin/NN is/VBZ a/DT paired/JJ fin/NN that/WDT is/VBZ located/JJ in/IN the/DT thoracic/JJ region/NN of/IN the/DT body/NN ./. <EOS>/<EOS>	pectoral fin := paired fin ^ E located in . ( thoracic region of body ) <EOS>
intramembranous/JJ ossification/NN is/VBZ a/DT direct/JJ ossification/NN that/WDT occur/VB within/IN mesenchyme/NN or/CC a/DT accumulation/NN of/IN relatively/RB unspecialized/JJ cell/NN ./. <EOS>/<EOS>	intramembranous ossification := direct ossification ^ E occur within . ( mesenchyme U accumulation of relatively unspecialized cell ) <EOS>
a/DT spicy/JJ pizza/NN is/VBZ any/DT pizza/NN that/WDT have/VB a/DT topping/VBG that/DT is/VBZ spicy/NN ./. <EOS>/<EOS>	spicy pizza := any pizza ^ E have topping . ( spicy topping ) <EOS>
a/DT currency/NN is/VBZ a/DT unit/NN of/IN exchange/NN ,/, facilitating/VBG the/DT transfer/NN of/IN goods/NN and/CC service/NN ./. <EOS>/<EOS>	currency := unit of exchange ^ E facilitating . ( transfer of goods ) ^ E facilitating . ( transfer of service ) <EOS>
a/DT vegetarian/JJ pizza/NN is/VBZ any/DT pizza/NN that/IN only/RB have/VB vegetarian/JJ topping/NN or/CC no/DT topping/NN ./. <EOS>/<EOS>	vegetarian pizza := pizza ^ E have topping . ( vegetarian topping ) U ! E have topping . ( T ) <EOS>
a/DT real/JJ italian/JJ pizza/NN is/VBZ a/DT type/NN of/IN pizza/NN that/WDT must/MD only/RB have/VB thin/JJ and/CC crispy/JJ basis/NN ./. <EOS>/<EOS>	real italian pizza := pizza ^ A have . ( thin basis ^ crispy basis ) <EOS>
a/DT juvenile/JJ is/VBZ a/DT young/JJ fish/NN or/CC animal/NN that/WDT have/VB not/RB reached/VBN sexual/JJ maturity/NN ./. <EOS>/<EOS>	juvenile := ( young fish U young animal ) ^ ! E have reached . ( sexual maturity ) <EOS>
biosphere/NN is/VBZ the/DT portion/NN of/IN earth/NN and/CC its/PRP$ atmosphere/NN that/WDT can/MD support/VB life/NN ./. <EOS>/<EOS>	biosphere := portion of earth ^ portion of its atmosphere ^ >= 0 support . ( life ) <EOS>
a/DT tetraploid/NN is/VBZ cell/NN or/CC organism/NN having/VBG NUM/CD set/NN of/IN chromosome/NN ./. <EOS>/<EOS>	tetraploid := ( cell U organism ) ^ = NUM having chromosome . ( set ) <EOS>
sensing/VBG is/VBZ a/DT process/NN that/WDT result/VB in/IN the/DT estimation/NN ,/, or/CC calculation/NN ,/, of/IN the/DT value/NN of/IN a/DT phenomenon/NN ./. <EOS>/<EOS>	sensing := process ^ E result in . ( estimation of value of phenomenon U calculation of value of phenomenon ) <EOS>
a/DT island/NN or/CC isle/NN is/VBZ any/DT piece/NN of/IN land/NN that/WDT is/VBZ completely/RB surrounded/VBN by/IN water/NN ./. <EOS>/<EOS>	island U isle := piece of land ^ A surrounded by . ( water ) <EOS>
tasty/JJ plant/NN are/VBP plant/NN eaten/VBD both/CC by/IN herbivore/NN and/CC carnivore/NN ./. <EOS>/<EOS>	tasty plant := plant ^ E eaten by . ( herbivore ) ^ E eaten by . ( carnivore ) <EOS>
tasty/JJ plant/NN are/VBP eaten/VBN both/CC by/IN herbivore/NN and/CC carnivore/NN ./. <EOS>/<EOS>	tasty plant := plant ^ E eaten by . ( herbivore ) ^ E eaten by . ( carnivore ) <EOS>
axial/JJ skeleton/NN is/VBZ a/DT skeletal/JJ subdivision/NN of/IN the/DT central/JJ body/NN axis/NN including/VBG the/DT cranium/NN ,/, vertebra/NN ,/, notochord/NN ,/, rib/NN ,/, and/CC sternum/NN ./. <EOS>/<EOS>	axial skeleton := skeletal subdivision of central body axis ^ E including . ( cranium ) ^ E including . ( vertebra ) ^ E including . ( notochord ) ^ E including . ( rib ) ^ E including . ( sternum ) <EOS>
carnivorous/JJ plant/NN are/VBP plant/NN that/IN eat/VB animal/NN ./. <EOS>/<EOS>	carnivorous plant := plant ^ E eat . ( animal ) <EOS>
an/DT endochondral/JJ bone/NN is/VBZ a/DT replacement/NN bone/NN that/WDT form/VB within/IN the/DT cartilage/NN ./. <EOS>/<EOS>	endochondral bone := replacement bone ^ E form within . cartilage <EOS>
the/DT anal/JJ fin/NN skeleton/NN is/VBZ a/DT median/JJ fin/NN skeleton/NN that/WDT is/VBZ located/VBN posterior/RB to/TO the/DT anus/NN ./. <EOS>/<EOS>	anal fin skeleton := median fin skeleton ^ E located posterior to . ( anus ) <EOS>
the/DT dorsal/NN fin/NN skeleton/NN is/VBZ a/DT median/JJ fin/NN skeleton/NN located/VBN on/IN the/DT dorsal/JJ surface/NN of/IN the/DT organism/NN ./. <EOS>/<EOS>	dorsal fin skeleton := median fin skeleton ^ E located on . ( dorsal surface of organism ) <EOS>
the/DT vertebral/JJ element/NN is/VBZ a/DT skeletal/JJ element/NN that/IN form/VB around/IN the/DT notochord/NN and/CC is/VBZ part/NN of/IN the/DT vertebral/JJ column/NN ./. <EOS>/<EOS>	vertebral element := skeletal element ^ E form around . ( notochord ) ^ E part of . ( vertebral column ) <EOS>
the/DT free/JJ limb/NN skeleton/NN is/VBZ a/DT skeletal/JJ subdivision/NN that/WDT is/VBZ part/NN of/IN the/DT limb/NN ./. <EOS>/<EOS>	free limb skeleton := skeletal subdivision ^ E part of . ( limb ) <EOS>
the/DT zeugopodial/JJ skeleton/NN is/VBZ the/DT section/NN of/IN the/DT forelimb/NN skeleton/NN located/VBN between/IN the/DT stylopodium/NN and/CC the/DT autopodium/NN ./. <EOS>/<EOS>	zeugopodial skeleton := E section of . ( forelimb skeleton ) ^ E located between . ( stylopodium ^ autopodium ) <EOS>
the/DT autopodial/JJ skeleton/NN is/VBZ the/DT distal/JJ section/NN of/IN the/DT limb/NN skeleton/NN ,/, consisting/VBG of/IN the/DT anterior/JJ autopodium/NN or/CC posterior/JJ autopodium/NN ./. <EOS>/<EOS>	autopodial skeleton := E distal section of . ( limb skeleton ) ^ E consisting of . ( anterior autopodium U posterior autopodium ) <EOS>
a/DT cheesey/NN pizza/NN is/VBZ any/DT pizza/NN that/WDT have/VB at/IN least/JJS NUM/CD cheese/NN topping/NN ./. <EOS>/<EOS>	cheesey pizza := pizza ^ >= NUM have topping . ( cheese topping ) <EOS>
any/DT pizza/NN that/WDT have/VB at/IN least/JJS NUM/CD cheese/NN topping/NN is/VBZ an/DT cheesey/JJ pizza/NN ./. <EOS>/<EOS>	cheesey pizza := pizza ^ >= NUM have topping . ( cheese topping ) <EOS>
any/DT pizza/NN that/WDT have/VB at/IN least/JJS NUM/CD topping/NN is/VBZ an/DT interesting/JJ pizza/NN ./. <EOS>/<EOS>	interesting pizza := pizza ^ >= NUM have topping . ( T ) <EOS>
any/DT pizza/NN that/WDT have/VB at/IN least/JJS NUM/CD meat/NN topping/NN is/VBZ a/DT meaty/JJ pizza/NN ./. <EOS>/<EOS>	meaty pizza := pizza ^ >= NUM have topping . ( meat topping ) <EOS>
a/DT named/VBN pizza/NN is/VBZ a/DT pizza/NN that/WDT can/MD be/VB found/VBN on/IN a/DT pizza/NN menu/NN ./. <EOS>/<EOS>	named pizza := pizza ^ E found on . ( pizza menu ) <EOS>
the/DT perichordal/JJ tissue/NN is/VBZ derived/VBN from/IN cell/NN surrounding/VBG the/DT notochord/NN ./. <EOS>/<EOS>	perichordal tissue := derived from ( cell ^ E surrounding . ( notochord ) ) <EOS>
the/DT odontoblast/NN is/VBZ a/DT skeletogenic/JJ cell/NN that/WDT secretes/VB dentine/NN matrix/NN ,/, is/VBZ derived/VBN from/IN the/DT odontogenic/JJ papilla/NN ,/, and/CC develop/VB from/IN a/DT preodontoblast/NN cell/NN ./. <EOS>/<EOS>	odontoblast := skeletogenic cell ^ E secretes . ( dentine matrix ) ^ E derived from . ( odontogenic papilla ) ^ E develop from . ( preodontoblast cell ) <EOS>
the/DT odontoblast/NN is/VBZ a/DT skeletogenic/JJ cell/NN that/WDT secretes/VB dentine/NN matrix/NN ./. <EOS>/<EOS>	odontoblast := skeletogenic cell ^ E secretes . ( dentine matrix ) <EOS>
the/DT odontoblast/NN is/VBZ a/DT skeletogenic/JJ cell/NN that/WDT is/VBZ derived/VBN from/IN the/DT odontogenic/JJ papilla/NN ./. <EOS>/<EOS>	odontoblast := skeletogenic cell ^ E derived from . ( odontogenic papilla ) <EOS>
the/DT odontocyte/NN is/VBZ a/DT skeletogenic/JJ cell/NN that/WDT secretes/VB dentine/NN matrix/NN and/CC is/VBZ derived/VBN from/IN odontogenic/JJ papilla/NN ./. <EOS>/<EOS>	odontocyte := skeletogenic cell ^ E secretes . ( dentine matrix ) ^ E derived from . ( odontogenic papilla ) <EOS>
the/DT odontocyte/NN is/VBZ a/DT skeletogenic/JJ cell/NN that/WDT secretes/VB dentine/NN matrix/NN ./. <EOS>/<EOS>	odontocyte := skeletogenic cell ^ E secretes . ( dentine matrix ) <EOS>
the/DT odontocyte/NN is/VBZ a/DT skeletogenic/JJ cell/NN that/WDT is/VBZ derived/VBN from/IN odontogenic/JJ papilla/NN ./. <EOS>/<EOS>	odontocyte := skeletogenic cell ^ E derived from . ( odontogenic papilla ) <EOS>
a/DT migratory/JJ neural/JJ crest/NN cell/NN is/VBZ a/DT cell/NN that/WDT is/VBZ derived/VBN from/IN the/DT specialized/JJ ectoderm/NN ./. <EOS>/<EOS>	migratory neural crest cell := cell ^ E derived from . ( specialized ectoderm ) <EOS>
a/DT craniofacial/JJ skeleton/NN is/VBZ a/DT cranial/JJ skeleton/NN derived/VBN from/IN neural/JJ crest/NN cell/NN ./. <EOS>/<EOS>	craniofacial skeleton := cranial skeleton ^ E derived from . ( neural crest cell ) <EOS>
integumentary/JJ skeleton/NN is/VBZ a/DT skeletal/JJ subdivision/NN that/WDT is/VBZ part/NN of/IN the/DT extra-oral/JJ dermal/JJ skeletal/NN system/NN ./. <EOS>/<EOS>	integumentary skeleton := skeletal subdivision ^ E part of . ( extra-oral dermal skeletal system ) <EOS>
the/DT postcranial/JJ axial/JJ skeleton/NN is/VBZ a/DT skeletal/JJ subdivision/NN of/IN the/DT central/JJ body/NN axis/VB that/WDT includes/VB vertebra/NN ,/, notochord/NN ,/, rib/NN ,/, and/CC sternum/NN ./. <EOS>/<EOS>	postcranial axial skeleton := skeletal subdivision of central body axis ^ E includes . ( vertebra U notochord U rib U sternum ) <EOS>
a/DT non-terminally/RB differentiated/VBN odontoblast/NN is/VBZ an/DT odontoblast/NN that/WDT is/VBZ located/VBN in/IN the/DT odontogenic/JJ papilla/NN and/CC dentine/NN tissue/NN ,/, and/CC transform/VB from/IN a/DT odontoblast/NN cell/NN ./. <EOS>/<EOS>	non-terminally differentiated odontoblast := odontoblast ^ E located in . ( odontogenic papilla U dentine tissue ) ^ E transform from . ( odontoblast cell ) <EOS>
the/DT hypertrophic/JJ chondrocyte/NN is/VBZ a/DT chondrocyte/NN that/WDT is/VBZ terminally/RB differentiated/VBN ./. <EOS>/<EOS>	hypertrophic chondrocyte := chondrocyte ^ E terminally differentiated . ( T ) <EOS>
the/DT hypertrophic/JJ chondrocyte/NN is/VBZ a/DT chondrocyte/NN that/WDT produce/VB type/JJ X/NN collagen/NN ./. <EOS>/<EOS>	hypertrophic chondrocyte := chondrocyte ^ E produce . ( type X collagen ) <EOS>
the/DT periarticular/JJ chondrocyte/NN is/VBZ a/DT chondrocyte/NN that/WDT is/VBZ located/VBN on/IN a/DT joint/JJ surface/NN and/CC that/DT is/VBZ part/NN of/IN articular/JJ cartilage/NN ./. <EOS>/<EOS>	periarticular chondrocyte := chondrocyte ^ E located on . ( joint surface ) ^ E part of . ( articular cartilage ) <EOS>
vasodentine/NN is/VBZ the/DT dentine/NN tissue/NN that/WDT lack/VB dentine/NN tubule/NN and/CC that/DT is/VBZ penetrated/VBN by/IN blood/NN capillary/NN ./. <EOS>/<EOS>	vasodentine := dentine tissue ^ E lack . ( dentine tubule ) ^ E penetrated by . ( blood capillary ) <EOS>
the/DT columnar/NN chondrocyte/NN is/VBZ a/DT chondrocyte/NN that/WDT is/VBZ linearly/RB arranged/VBN with/IN other/JJ columnar/NN chondrocytes/NN ./. <EOS>/<EOS>	columnar chondrocyte := chondrocyte ^ E linearly arranged with . ( columnar chondrocytes ) <EOS>
a/DT mineralized/JJ bone/NN tissue/NN is/VBZ a/DT bone/NN tissue/NN that/WDT is/VBZ mineralized/VBN with/IN hydroxyapatite/NN ./. <EOS>/<EOS>	mineralized bone tissue := bone tissue ^ E mineralized with . ( hydroxyapatite ) <EOS>
a/DT cellular/JJ bone/NN tissue/NN is/VBZ a/DT mineralized/JJ bone/NN tissue/NN that/WDT always/RB include/VB non-terminally/RB differentiated/JJ osteoblast/NN and/CC osteocyte/NN ./. <EOS>/<EOS>	cellular bone tissue := mineralized bone tissue ^ E include . ( non-terminally differentiated osteoblast U osteocyte ) <EOS>
the/DT acellular/JJ bone/NN tissue/NN is/VBZ a/DT mineralized/JJ bone/NN tissue/NN that/WDT have/VB terminally/RB differentiated/VBN osteoblast/NN but/CC lack/VB osteocyte/NN ./. <EOS>/<EOS>	acellular bone tissue := mineralized bone tissue ^ E have terminally differentiated osteoblast . ( T ) ^ E lack . ( osteocyte ) <EOS>
the/DT pectoral/JJ appendage/NN is/VBZ the/DT anterior/JJ paired/JJ appendage/NN ./. <EOS>/<EOS>	pectoral appendage := anterior paired appendage <EOS>
the/DT pelvic/JJ appendage/NN is/VBZ a/DT posterior/JJ paired/JJ appendage/NN ./. <EOS>/<EOS>	pelvic appendage := posterior paired appendage <EOS>
a/DT ossified/JJ tendon/NN is/VBZ a/DT sesamoid/NN that/WDT develop/VB within/IN a/DT tendon/NN and/CC is/VBZ distal/JJ to/TO an/DT articulation/NN or/CC joint/NN ./. <EOS>/<EOS>	ossified tendon := sesamoid ^ E develop within . ( tendon ) ^ E distal to . ( articulation U joint ) <EOS>
a/DT ossified/JJ tendon/NN is/VBZ a/DT sesamoid/NN that/WDT develop/VB within/IN a/DT tendon/NN ./. <EOS>/<EOS>	ossified tendon := sesamoid ^ E develop within . ( tendon ) <EOS>
a/DT replacement/NN element/NN is/VBZ a/DT skeletal/JJ element/NN that/WDT form/VB as/IN a/DT replacement/NN or/CC substitution/NN of/IN another/DT element/NN or/CC tissue/NN ./. <EOS>/<EOS>	replacement element := skeletal replacement element ^ E form as . ( replacement of element U substitution of element U replacement of tissue U substitution of tissue ) <EOS>
a/DT ligamentous/JJ replacement/NN element/NN is/VBZ a/DT replacement/NN element/NN that/WDT form/VB as/IN a/DT replacement/NN of/IN a/DT ligament/NN ./. <EOS>/<EOS>	ligamentous replacement element := replacement element ^ E form as . ( replacement of ligament ) <EOS>
the/DT pectoral/JJ fin/NN skeleton/NN is/VBZ a/DT paired/JJ fin/NN skeleton/NN that/IN consists/VB of/IN the/DT supporting/VBG endochondral/JJ proximal/NN and/CC distal/JJ radial/NN and/CC the/DT dermal/JJ fin/NN ray/NN or/CC lepidotrichia/NN ./. <EOS>/<EOS>	pectoral fin skeleton := paired fin skeleton ^ E consists of . ( supporting endochondral proximal U distal radial U dermal fin ray U dermal fin lepidotrichia ) <EOS>
the/DT pectoral/JJ fin/NN skeleton/NN is/VBZ a/DT paired/JJ fin/NN skeleton/NN that/WDT is/VBZ located/VBN in/IN the/DT thoracic/JJ region/NN of/IN the/DT body/NN and/CC articulate/VB with/IN the/DT scapula/NN and/CC the/DT coracoid/NN ./. <EOS>/<EOS>	pectoral fin skeleton := paired fin skeleton ^ E located in . ( thoracic region of body ) ^ E articulate with . ( scapula ) ^ E articulate with . ( coracoid ) <EOS>
ossified/VBN ligament/NN are/VBP sesamoid/NN that/IN develop/VB within/IN a/DT ligament/NN ,/, distal/NN to/TO an/DT articulation/NN or/CC joint/NN ./. <EOS>/<EOS>	ossified ligament := sesamoid ^ E develop within . ( ligament ) ^ E distal to . ( articulation U joint ) <EOS>
a/DT paired/JJ fin/NN skeleton/NN is/VBZ a/DT skeletal/JJ system/NN that/WDT consists/VB of/IN the/DT paired/JJ fin/NN (/( pectoral/JJ or/CC pelvic/JJ fin/NN )/) ./. <EOS>/<EOS>	paired fin skeleton := skeletal system ^ E consists of . ( paired fin ) <EOS>
a/DT pectoral/JJ fin/NN skeleton/NN is/VBZ a/DT paired/JJ fin/NN skeleton/NN that/IN consists/VB of/IN the/DT supporting/VBG endochondral/JJ proximal/NN and/CC distal/JJ radial/NN and/CC the/DT dermal/JJ fin/NN ray/NN or/CC lepidotrichia/NN ./. <EOS>/<EOS>	pectoral fin skeleton := paired fin skeleton ^ E consists of . ( supporting endochondral radial ^ distal radial ^ ( dermal fin ray U dermal fin lepidotrichia ) ) <EOS>
the/DT pectoral/JJ fin/NN skeleton/NN is/VBZ located/VBN in/IN the/DT thoracic/JJ region/NN of/IN the/DT body/NN and/CC articulates/VB with/IN the/DT scapula/NN and/CC coracoid/NN ./. <EOS>/<EOS>	pectoral fin skeleton := E located in . ( thoracic region of body ) ^ E articulates with . ( scapula ^ coracoid ) <EOS>
the/DT pelvic/JJ fin/NN skeleton/NN is/VBZ a/DT paired/JJ fin/NN skeleton/NN located/VBN in/IN the/DT abdominal/JJ position/NN that/IN consists/VB of/IN supporting/VBG endochondral/JJ radial/NN and/CC dermal/JJ fin/NN ray/NN or/CC lepidotrichia/NN ./. <EOS>/<EOS>	pelvic fin skeleton := paired fin skeleton ^ E located in . ( abdominal position ) ^ E consists of . ( supporting endochondral radial ^ ( dermal fin ray U dermal fin lepidotrichia ) ) <EOS>
a/DT ossified/JJ ligament/NN is/VBZ a/DT sesamoid/NN that/WDT develop/VB within/IN a/DT ligament/NN ,/, distal/NN to/TO an/DT articulation/NN or/CC joint/NN ./. <EOS>/<EOS>	ossified ligament := sesamoid ^ E develop within . ( ligament ) ^ E distal to . ( articulation U joint ) <EOS>
an/DT interclavicle/NN is/VBZ a/DT dermal/JJ bone/NN of/IN pectoral/JJ girdle/NN that/WDT is/VBZ median/JJ and/CC ventral/JJ in/IN position/NN ./. <EOS>/<EOS>	interclavicle := dermal bone of pectoral girdle ^ E median in . ( position ) ^ E ventral in . ( position ) <EOS>
a/DT paired/JJ fin/NN skeleton/NN is/VBZ a/DT skeletal/JJ system/NN that/WDT consists/VB of/IN the/DT paired/JJ fin/NN (/( pectoral/JJ or/CC pelvic/JJ fin/NN )/) ./. <EOS>/<EOS>	paired fin skeleton := skeletal system ^ E consists of . ( paired fin ) <EOS>
a/DT median/JJ fin/NN skeleton/NN is/VBZ a/DT postcranial/JJ axial/JJ skeleton/NN that/WDT is/VBZ unpaired/JJ and/CC located/VBN on/IN the/DT sagittal/JJ plane/NN of/IN the/DT organism/NN ./. <EOS>/<EOS>	median fin skeleton := postcranial axial skeleton ^ E unpaired . ( T ) ^ E located on . ( sagittal plane of the organism ) <EOS>
the/DT scapular/NN complex/NN is/VBZ a/DT skeletal/JJ subdivision/NN of/IN dermal/JJ bone/NN that/WDT may/MD include/VB the/DT anterolateral/JJ plate/NN ,/, the/DT spinal/JJ process/NN ,/, and/CC anteroventral/JJ plate/NN (/( av/NN )/) and/CC other/JJ dermal/JJ bone/NN that/WDT are/VBP part/NN of/IN the/DT pectoral/JJ girdle/NN ./. <EOS>/<EOS>	scapular complex := skeletal subdivision of dermal bone ^ E include . ( anterolateral plate U the spinal process U anteroventral plate U ( dermal bone ^ E part of . ( pectoral girdle ) ) <EOS>
the/DT vertebral/JJ column/NN is/VBZ the/DT anatomical/JJ cluster/NN that/WDT consists/VB of/IN vertebra/NN of/IN the/DT body/NN ./. <EOS>/<EOS>	vertebral column := anatomical cluster ^ E consists of . ( vertebra of body ) <EOS>
the/DT fin/NN skeleton/NN is/VBZ the/DT skeletal/JJ subdivision/NN that/WDT is/VBZ part/NN of/IN the/DT paired/JJ fin/NN ./. <EOS>/<EOS>	fin skeleton := skeletal subdivision ^ E part of . ( paired fin ) <EOS>
the/DT limb/NN skeleton/NN is/VBZ the/DT skeletal/JJ subdivision/NN that/WDT is/VBZ part/NN of/IN the/DT paired/JJ limb/NN ./. <EOS>/<EOS>	limb skeleton := skeletal subdivision ^ E part of . ( paired limb ) <EOS>
the/DT girdle/NN skeleton/NN is/VBZ a/DT skeletal/JJ subdivision/NN that/WDT is/VBZ part/NN of/IN the/DT appendage/NN girdle/NN region/NN ./. <EOS>/<EOS>	girdle skeleton := skeletal subdivision ^ E part of . ( appendage girdle region ) <EOS>
the/DT perichordal/NN bone/NN is/VBZ the/DT bone/NN element/NN that/WDT is/VBZ adjacent/JJ to/TO the/DT notochord/NN ./. <EOS>/<EOS>	perichordal bone := bone element ^ E adjacent to . ( notochord ) <EOS>
the/DT perichondral/JJ bone/NN is/VBZ the/DT bone/NN element/NN that/WDT is/VBZ located/VBN on/IN the/DT surface/NN of/IN a/DT cartilage/NN element/NN ./. <EOS>/<EOS>	perichondral bone := bone element ^ E located on . ( surface of cartilage element ) <EOS>
the/DT acropodial/JJ skeleton/NN is/VBZ a/DT endochondral/JJ terminal/JJ bone/NN that/WDT is/VBZ located/VBN at/IN the/DT distalmost/JJ end/NN of/IN the/DT autopodium/NN ,/, consisting/VBG of/IN the/DT phalanx/NN ./. <EOS>/<EOS>	acropodial skeleton := endochondral terminal bone ^ E located at . ( distalmost end of autopodium ) ^ E consisting of . ( phalanx ) <EOS>
an/DT integumentary/JJ papilla/NN is/VBZ an/DT odontogenic/JJ papilla/NN that/WDT is/VBZ located/VBN in/IN the/DT integument/NN ./. <EOS>/<EOS>	integumentary papilla := odontogenic papilla ^ E located in . ( integument ) <EOS>
the/DT oropharyngeal/JJ papilla/NN is/VBZ an/DT odontogenic/JJ papilla/NN located/VBN along/IN the/DT jaw/NN or/CC pharyngeal/JJ skeleton/NN ./. <EOS>/<EOS>	oropharyngeal papilla := odontogenic papilla ^ E located along . ( jaw U pharyngeal skeleton ) <EOS>
the/DT bone/NN element/NN is/VBZ a/DT skeletal/JJ element/NN that/WDT is/VBZ composed/VBN of/IN bone/NN tissue/NN ./. <EOS>/<EOS>	bone element := skeletal element ^ E composed of . ( bone tissue ) <EOS>
an/DT osteoblast/NN is/VBZ a/DT skeletogenic/JJ cell/NN that/WDT secretes/VB osteoid/JJ ,/, is/VBZ capable/JJ of/IN producing/VBG mineralized/VBN matrix/NN ,/, is/VBZ located/VBN adjacent/JJ to/TO or/CC within/IN osteoid/JJ tissue/NN ,/, and/CC arises/NN from/IN the/DT transformation/NN of/IN a/DT preosteoblast/NN cell/NN ./. <EOS>/<EOS>	osteoblast := skeletogenic cell ^ E secretes . ( osteoid ) ^ E producing . ( mineralized matrix ) ^ E ( located adjacent to ^ located within ) . ( osteoid tissue ) ^ E arises from . ( transformation of preosteoblast cell ) <EOS>
an/DT osteoblast/NN is/VBZ a/DT skeletogenic/JJ cell/NN that/WDT secretes/VB osteoid/PRP ./. <EOS>/<EOS>	osteoblast := skeletogenic cell ^ E secretes . ( osteoid ) <EOS>
an/DT osteoblast/NN is/VBZ a/DT skeletogenic/JJ cell/NN that/WDT is/VBZ located/VBN adjacent/JJ to/TO or/CC within/IN osteoid/JJ tissue/NN ./. <EOS>/<EOS>	osteoblast := skeletogenic cell ^ E ( located adjacent to ^ located within ) . ( osteoid tissue ) <EOS>
a/DT cementoblast/NN is/VBZ a/DT skeletogenic/JJ cell/NN that/WDT produce/VB cementum/NN ,/, is/VBZ part/NN of/IN the/DT odontogenic/JJ papilla/NN ,/, and/CC develop/VB from/IN a/DT precementoblast/NN cell/NN ./. <EOS>/<EOS>	cementoblast := skeletogenic cell ^ E produce . ( cementum ) ^ E part of . ( odontogenic papilla ) ^ E develop from . ( precementoblast cell ) <EOS>
the/DT caudal/NN fin/NN skeleton/NN is/VBZ a/DT median/JJ fin/NN skeleton/NN supporting/VBG the/DT caudal/NN fin/NN ./. <EOS>/<EOS>	caudal fin skeleton := median fin skeleton ^ E supporting . ( caudal fin ) <EOS>
the/DT pelvic/JJ fin/NN lepidotrichium/NN is/VBZ a/DT lepidotrichium/NN that/WDT is/VBZ part/NN of/IN the/DT pelvic/JJ fin/NN skeleton/NN ./. <EOS>/<EOS>	pelvic fin lepidotrichium := lepidotrichium ^ E part of . ( pelvic fin skeleton ) <EOS>
the/DT caudal/NN fin/NN lepidotrichium/NN is/VBZ a/DT lepidotrichium/NN that/WDT is/VBZ part/NN of/IN the/DT caudal/NN fin/NN skeleton/NN ./. <EOS>/<EOS>	caudal fin lepidotrichium := lepidotrichium ^ E part of . ( caudal fin skeleton ) <EOS>
the/DT pectoral/JJ fin/NN lepidotrichium/NN is/VBZ a/DT lepidotrichium/NN that/WDT is/VBZ part/NN of/IN the/DT pectoral/JJ fin/NN skeleton/NN ./. <EOS>/<EOS>	pectoral fin lepidotrichium := lepidotrichium ^ E part of . ( pectoral fin skeleton ) <EOS>
the/DT anal/JJ fin/NN lepidotrichium/NN is/VBZ a/DT lepidotrichium/NN that/WDT is/VBZ part/NN of/IN the/DT anal/JJ fin/NN skeleton/NN ./. <EOS>/<EOS>	anal fin lepidotrichium := lepidotrichium ^ E part of . ( anal fin skeleton ) <EOS>
the/DT dorsal/NN fin/NN lepidotrichium/NN is/VBZ a/DT lepidotrichium/NN that/WDT is/VBZ part/NN of/IN the/DT dorsal/NN fin/NN skeleton/NN ./. <EOS>/<EOS>	dorsal fin lepidotrichium := lepidotrichium ^ E part of . ( dorsal fin skeleton ) <EOS>
the/DT embryonic/JJ cell/NN is/VBZ a/DT cell/NN of/IN the/DT embryo/NN ./. <EOS>/<EOS>	embryonic cell := cell of the embryo <EOS>
the/DT fin/NN is/VBZ a/DT surface/NN structure/NN involved/VBN in/IN locomotion/NN ./. <EOS>/<EOS>	fin := surface structure ^ E involved in . ( locomotion ) <EOS>
the/DT median/JJ fin/NN is/VBZ an/DT unpaired/JJ fin/NN that/WDT is/VBZ located/VBN in/IN the/DT sagittal/JJ plane/NN of/IN the/DT organism/NN ./. <EOS>/<EOS>	median fin := unpaired fin ^ E located in . ( sagittal plane of organism ) <EOS>
the/DT anal/JJ fin/NN is/VBZ a/DT median/JJ fin/NN that/WDT is/VBZ located/VBN posterior/RB to/TO the/DT anus/NN ./. <EOS>/<EOS>	anal fin := median fin ^ E located posterior to . ( anus ) <EOS>
the/DT dorsal/NN fin/NN is/VBZ a/DT median/JJ fin/NN located/VBN on/IN the/DT dorsal/JJ surface/NN of/IN the/DT organism/NN ./. <EOS>/<EOS>	dorsal fin := median fin ^ E located on . ( dorsal surface of organism ) <EOS>
the/DT caudal/NN fin/NN is/VBZ the/DT most/RBS posterior/JJ median/JJ fin/NN ./. <EOS>/<EOS>	caudal fin := most posterior median fin <EOS>
the/DT articular/JJ system/NN is/VBZ an/DT anatomical/JJ system/NN that/WDT consists/VB of/IN all/PDT the/DT joint/NN of/IN the/DT body/NN ./. <EOS>/<EOS>	articular system := anatomical system ^ E consists of . ( joint of body ) <EOS>
the/DT vertebral/JJ centrum/NN is/VBZ a/DT skeletal/JJ element/NN that/WDT surround/VB the/DT notochord/NN ./. <EOS>/<EOS>	vertebral centrum := skeletal element ^ E surround . ( notochord ) <EOS>
a/DT two-dimensional/JJ region/NN is/VBZ a/DT spatial/JJ region/NN that/WDT have/VB NUM/CD dimension/NN ./. <EOS>/<EOS>	two-dimensional region := spatial region = NUM have dimension . ( T ) <EOS>
a/DT three-dimensional/JJ region/NN is/VBZ a/DT spatial/JJ region/NN that/WDT have/VB NUM/CD dimension/NN ./. <EOS>/<EOS>	three-dimensional region := spatial region = NUM have dimension . ( T ) <EOS>
an/DT authority/NN operation/NN is/VBZ an/DT operation/NN or/CC activity/NN initiated/VBN by/IN the/DT authority/NN that/WDT can/MD disrupt/VB traffic/NN ./. <EOS>/<EOS>	authority operation := ( operation U activity ) ^ E initiated by . ( authority ) ^ E disrupt . ( traffic ) <EOS>
a/DT crowd/NN is/VBZ a/DT major/JJ gathering/NN of/IN people/NN that/WDT can/MD disrupt/VB traffic/NN ./. <EOS>/<EOS>	crowd := major gathering of people ^ >= 0 disrupt . ( traffic ) <EOS>
a/DT public/JJ event/NN is/VBZ an/DT organized/JJ event/NN which/WDT can/MD disrupt/VB traffic/NN ./. <EOS>/<EOS>	public event := organized event ^ >= 0 disrupt . ( traffic ) <EOS>
an/DT agricultural/JJ show/NN or/CC event/NN is/VBZ something/NN that/WDT can/MD disrupt/VB traffic/NN ./. <EOS>/<EOS>	agricultural show U agricultural event := >= 0 disrupt . ( traffic ) <EOS>
an/DT air/NN show/NN or/CC other/JJ areonautical/JJ event/NN is/VBZ something/NN that/WDT can/MD disrupt/VB traffic/NN ./. <EOS>/<EOS>	air show U areonautical event := >= 0 disrupt . ( traffic ) <EOS>
an/DT athletics/NN meeting/NN is/VBZ an/DT event/NN that/WDT can/MD disrupt/VB traffic/NN ./. <EOS>/<EOS>	athletics meeting := event ^ >= 0 disrupt . ( traffic ) <EOS>
a/DT baseball/NN game/NN is/VBZ an/DT event/NN that/WDT can/MD disrupt/VB traffic/NN ./. <EOS>/<EOS>	baseball game := event ^ >= 0 disrupt . ( traffic ) <EOS>
a/DT basketball/NN game/NN is/VBZ an/DT event/NN that/WDT can/MD disrupt/VB traffic/NN ./. <EOS>/<EOS>	basketball game := event ^ >= 0 disrupt . ( traffic ) <EOS>
a/DT bicycle/NN race/NN is/VBZ something/NN that/WDT can/MD disrupt/VB traffic/NN ./. <EOS>/<EOS>	bicycle race := >= 0 disrupt . ( traffic ) <EOS>
a/DT boat/NN race/NN or/CC regatta/NN is/VBZ something/NN that/WDT can/MD disrupt/VB traffic/NN ./. <EOS>/<EOS>	boat race := >= 0 disrupt . ( traffic ) <EOS>
a/DT boat/NN show/NN is/VBZ something/NN which/WDT can/MD disrupt/VB traffic/NN ./. <EOS>/<EOS>	boat show := >= 0 disrupt . ( traffic ) <EOS>
a/DT bull/NN fight/NN is/VBZ an/DT event/NN that/WDT can/MD disrupt/VB traffic/NN ./. <EOS>/<EOS>	bull fight := event ^ >= 0 disrupt . ( traffic ) <EOS>
a/DT commercial/JJ event/NN is/VBZ an/DT event/NN which/WDT could/MD disrupt/VB traffic/NN ./. <EOS>/<EOS>	commercial event := event ^ >= 0 disrupt . ( traffic ) <EOS>
a/DT concert/NN is/VBZ an/DT event/NN that/WDT can/MD disrupt/VB traffic/NN ./. <EOS>/<EOS>	concert := event ^ >= 0 disrupt . ( traffic ) <EOS>
a/DT cultural/JJ event/NN is/VBZ an/DT event/NN that/WDT can/MD disrupt/VB traffic/NN ./. <EOS>/<EOS>	cultural event := event ^ >= 0 disrupt . ( traffic ) <EOS>
an/DT exhibition/NN is/VBZ a/DT major/JJ display/NN or/CC trade/NN show/VBP that/IN can/MD disrupt/VB traffic/NN ./. <EOS>/<EOS>	exhibition := ( major display U major trade show ) ^ >= disrupt . ( traffic ) <EOS>
a/DT football/NN match/NN is/VBZ an/DT event/NN that/WDT can/MD disrupt/VB traffic/NN ./. ./. <EOS>/<EOS>	football match := event ^ >= 0 disrupt . ( traffic ) <EOS>
a/DT motor/NN show/NN is/VBZ an/DT event/NN that/WDT can/MD disrupt/VB traffic/NN ./. <EOS>/<EOS>	motor show := event ^ >= 0 disrupt . ( traffic ) <EOS>
a/DT motor/NN sport/NN race/NN meeting/NN is/VBZ an/DT event/NN that/WDT can/MD disrupt/VB traffic/NN ./. <EOS>/<EOS>	motor sport race meeting := event ^ >= 0 disrupt . ( traffic ) <EOS>
a/DT parade/NN is/VBZ a/DT formal/JJ display/NN or/CC organized/VBN procession/NN which/WDT can/MD disrupt/VB traffic/NN ./. <EOS>/<EOS>	parade := ( formal display U organized procession ) ^ >= 0 disrupt . ( traffic ) <EOS>
a/DT procession/NN or/CC an/DT organized/VBN procession/NN is/VBZ something/NN that/WDT can/MD disrupt/VB traffic/NN ./. <EOS>/<EOS>	procession U organized procession := >= 0 disrupt . ( traffic ) <EOS>
a/DT race/NN meeting/NN is/VBZ something/NN that/WDT can/MD disrupt/VB traffic/NN ./. <EOS>/<EOS>	race meeting := >= 0 disrupt . ( traffic ) <EOS>
a/DT rugby/NN match/NN is/VBZ an/DT event/NN that/WDT can/MD disrupt/VB traffic/NN ./. <EOS>/<EOS>	rugby match := event ^ >= 0 disrupt . ( traffic ) <EOS>
a/DT tennis/NN tournament/NN is/VBZ an/DT event/NN that/WDT can/MD disrupt/VB traffic/NN ./. <EOS>/<EOS>	tennis tournament := event ^ >= 0 disrupt . ( traffic ) <EOS>
a/DT water/NN sport/NN meeting/NN is/VBZ an/DT event/NN that/WDT can/MD disrupt/VB traffic/NN ./. <EOS>/<EOS>	water sport meeting := event ^ >= 0 disrupt . ( traffic ) <EOS>
a/DT winter/NN sport/NN meeting/NN or/CC event/NN is/VBZ an/DT event/NN that/WDT could/MD disrupt/VB traffic/NN ./. <EOS>/<EOS>	winter sport meeting U winter sport event := event ^ >= 0 disrupt . ( traffic ) <EOS>
hail/NN are/VBP falling/VBG ice/NN pellet/NN or/CC frozen/JJ rain/NN ./. <EOS>/<EOS>	hail := falling ice pellet or frozen rain <EOS>
heavy/JJ frost/NN is/VBZ a/DT thick/JJ coating/NN of/IN frost/NN ./. <EOS>/<EOS>	heavy frost := thick coating of frost <EOS>
shower/NN are/VBP light/JJ rain/NN or/CC intermittent/NN rain/NN ./. <EOS>/<EOS>	shower := light rain U intermittent rain <EOS>
animal/NN on/IN the/DT infrastructure/NN may/MD disrupt/VB traffic/NN ./. <EOS>/<EOS>	animal on infrastructure := >= 0 disrupt . ( traffic ) <EOS>
herd/NN of/IN animal/NN on/IN the/DT infrastructure/NN may/MD disrupt/VB traffic/NN ./. <EOS>/<EOS>	herd of animal on infrastructure := >= 0 disrupt . ( traffic ) <EOS>
large/JJ animal/NN on/IN the/DT infrastructure/NN may/MD disrupt/VB traffic/NN ./. <EOS>/<EOS>	large animal on infrastructure := >= 0 disrupt . ( traffic ) <EOS>
mud/NN slide/NN may/MD obstruct/VB transport/NN infrastructure/NN ./. <EOS>/<EOS>	mud := >= 0 obstruct . ( transport infrastructure ) <EOS>
rockfalls/NN may/MD obstruct/VB transport/NN infrastructure/NN ./. <EOS>/<EOS>	rockfalls := >= 0 obstruct . ( transport infrastructure ) <EOS>
a/DT damaged/VBN bridge/NN may/MD cause/VB traffic/NN disruption/NN ./. <EOS>/<EOS>	damaged bridge := >= 0 cause . ( traffic disruption ) <EOS>
a/DT damaged/VBN crash/NN barrier/NN may/MD cause/VB traffic/NN disruption/NN ./. <EOS>/<EOS>	damaged crash := >= 0 cause . ( traffic disruption ) <EOS>
a/DT damaged/VBN flyover/NN may/MD cause/VB traffic/NN disruption/NN ./. <EOS>/<EOS>	damaged flyover := >= 0 cause . ( traffic disruption ) <EOS>
a/DT damaged/VBN gantry/NN may/MD cause/VB traffic/NN disruption/NN ./. <EOS>/<EOS>	damaged gantry := >= 0 cause . ( traffic disruption ) <EOS>
a/DT damaged/VBN road/NN surface/NN may/MD cause/VB traffic/NN disruption/NN ./. <EOS>/<EOS>	damaged road := >= 0 cause . ( traffic disruption ) <EOS>
a/DT damaged/VBN tunnel/NN may/MD cause/VB traffic/NN disruption/NN ./. <EOS>/<EOS>	damaged tunnel := >= 0 cause . ( traffic disruption ) <EOS>
a/DT damaged/VBN viaduct/NN may/MD cause/VB traffic/NN disruption/NN ./. <EOS>/<EOS>	damaged viaduct := >= 0 cause . ( traffic disruption ) <EOS>
a/DT broken/JJ down/RP vehicle/NN (/( s/PRP )/) may/MD cause/VB traffic/NN disruption/NN ./. <EOS>/<EOS>	broken down vehicle := >= 0 cause . ( traffic disruption ) <EOS>
a/DT product/NN is/VBZ everything/NN that/WDT is/VBZ produced/VBN by/IN an/DT event/NN ./. <EOS>/<EOS>	product := E produced by . ( event ) <EOS>
an/DT adaptor/NN is/VBZ a/DT user/NN that/WDT produce/VB an/DT adaptation/NN ./. <EOS>/<EOS>	adaptor := user ^ E produce . ( adaptation ) <EOS>
an/DT action/NN is/VBZ the/DT exercise/NN of/IN a/DT right/NN ./. <EOS>/<EOS>	action := exercise of right <EOS>
a/DT measurement/JJ unit/NN label/NN is/VBZ a/DT datum/NN item/NN label/NN that/WDT denotes/VB a/DT unit/NN of/IN measure/NN ./. <EOS>/<EOS>	measurement unit label := datum item label ^ E denotes . ( unit of measure ) <EOS>
a/DT dichotomous/JJ variable/JJ specification/NN is/VBZ a/DT variable/JJ that/WDT have/VB NUM/CD category/NN ./. <EOS>/<EOS>	dichotomous variable specification := variable ^ = NUM have category . ( T ) <EOS>
a/DT kindergarten/NN is/VBZ the/DT location/NN that/WDT is/VBZ used/VBN for/IN pre-school/JJ education/NN ./. <EOS>/<EOS>	kindergarten := location ^ E used for . ( pre-school education ) <EOS>
a/DT school/NN is/VBZ a/DT building/NN or/CC location/NN that/WDT is/VBZ used/VBN for/IN instructional/JJ class/NN ./. <EOS>/<EOS>	school := ( building U location ) ^ E used for . ( instructional class ) <EOS>
a/DT university/NN or/CC a/DT college/NN is/VBZ an/DT institution/NN of/IN higher/JJR education/NN ./. <EOS>/<EOS>	university U college := institution of higher education <EOS>
a/DT ski/NN lift/NN station/NN is/VBZ the/DT start/JJ point/NN of/IN a/DT ski/NN lift/NN ./. <EOS>/<EOS>	ski lift station := start point of ski lift <EOS>
a/DT ski/NN resort/NN is/VBZ a/DT down/RP hill/NN or/CC cross-country/NN ski/NN facility/NN ./. <EOS>/<EOS>	ski resort := down hill ski facility U cross-country ski facility <EOS>
a/DT datum/NN collection/NN by/IN censoring/VBG is/VBZ a/DT datum/NN collection/NN that/WDT result/NN in/IN a/DT collection/NN of/IN datum/NN generated/VBN from/IN an/DT censoring/NN ./. <EOS>/<EOS>	datum collection by censoring := datum collection ^ E result in . ( collection of <EOS> datum ^ E generated from . ( censoring ) ) <EOS>
a/DT datum/NN collection/NN from/IN survey/NN is/VBZ a/DT datum/NN collection/NN that/WDT result/NN in/IN a/DT collection/NN of/IN datum/NN generated/VBN from/IN a/DT survey/NN ./. <EOS>/<EOS>	datum collection from survey := datum collection ^ E result in . ( collection of <EOS> datum ^ E generated from . ( survey ) ) <EOS>
a/DT datum/NN collection/NN from/IN experiment/NN is/VBZ a/DT datum/NN collection/NN process/NN that/WDT result/NN in/IN a/DT collection/NN of/IN datum/NN generated/VBN from/IN an/DT experiment/NN ./. <EOS>/<EOS>	datum collection from experiment := datum collection ^ E result in . ( collection of <EOS> datum ^ E generated from . ( experiment ) ) <EOS>
a/DT datum/NN collection/NN from/IN literature/NN is/VBZ a/DT datum/NN collection/NN process/NN that/WDT result/NN in/IN a/DT collection/NN of/IN datum/NN from/IN the/DT literature/NN ./. <EOS>/<EOS>	datum collection from literature := datum collection process ^ E result in . ( collection of datum from literature ) <EOS>
an/DT employee/NN is/VBZ a/DT person/NN that/WDT work/VB for/IN a/DT company/NN ./. <EOS>/<EOS>	employee := person ^ E work for . ( company ) <EOS>
a/DT team/NN is/VBZ a/DT group/NN of/IN employee/NN ./. <EOS>/<EOS>	team := group of employee <EOS>
each/DT employee/NN is/VBZ part/NN of/IN a/DT team/NN ./. <EOS>/<EOS>	employee := E part of . ( team ) <EOS>
a/DT manager/NN is/VBZ an/DT employee/NN that/WDT lead/VB at/IN least/JJS NUM/CD team/NN ./. <EOS>/<EOS>	manager := employee ^ >= NUM lead . ( team ) <EOS>
a/DT top/JJ manager/NN is/VBZ a/DT manager/NN that/WDT lead/VB more/JJR than/IN NUM/CD team/NN ./. <EOS>/<EOS>	top manager := manager ^ >= NUM lead . ( team ) <EOS>
every/DT employee/NN report/NN to/TO at/IN least/JJS NUM/CD manager/NN ./. <EOS>/<EOS>	employee := >= NUM report to . ( manager ) <EOS>
every/DT employee/NN use/VB a/DT desk/NN ./. <EOS>/<EOS>	employee := E use . ( desk ) <EOS>
desk/NN are/VBP piece/NN of/IN funriture/NN ./. <EOS>/<EOS>	desk := piece of funriture <EOS>
piece/NN of/IN furniture/NN are/VBP artifact/VB that/IN furnish/VB a/DT room/NN ./. <EOS>/<EOS>	piece of furniture := artifact ^ E furnish . ( room ) <EOS>
room/NN are/VBP part/NN of/IN the/DT building/NN ./. <EOS>/<EOS>	room := E part of . ( building ) <EOS>
window/NN are/VBP part/NN of/IN a/DT room/NN ./. <EOS>/<EOS>	window := E part of . ( room ) <EOS>
the/DT door/NN are/VBP part/NN of/IN room/NN ./. <EOS>/<EOS>	door := E part of . ( room ) <EOS>
a/DT team/NN is/VBZ a/DT group/NN of/IN employee/NN that/WDT report/VB to/TO a/DT manager/NN ./. <EOS>/<EOS>	team := group of employee ^ E report to . ( manager ) <EOS>
every/DT team/NN develop/VB at/IN least/JJS NUM/CD leading/VBG project/NN ./. <EOS>/<EOS>	team := >= NUM develop . ( leading project ) <EOS>
a/DT team/NN follow/VB more/JJR than/IN NUM/CD side/NN project/NN ./. <EOS>/<EOS>	team := >= NUM follow . ( side project ) <EOS>
every/DT team/NN develop/VB at/IN most/JJS NUM/CD project/NN ./. <EOS>/<EOS>	team := <= NUM develop . ( project ) <EOS>
a/DT team/NN pursue/VB an/DT goal/NN ./. <EOS>/<EOS>	team := E pursue . ( goal ) <EOS>
a/DT team/NN implement/VB trimestral/JJ activity/NN ./. <EOS>/<EOS>	team := E implement . ( trimestral activity ) <EOS>
each/DT project/NN have/VB exactly/RB NUM/CD deadline/NN ./. <EOS>/<EOS>	project := = NUM have deadline . ( T ) <EOS>
trimestral/JJ activity/NN are/VBP activity/NN that/WDT take/VB exactly/RB NUM/CD month/NN ./. <EOS>/<EOS>	trimestral activity := activity ^ = NUM take . ( month ) <EOS>
activity/NN are/VBP part/NN of/IN a/DT process/NN ./. <EOS>/<EOS>	activity := E part of . ( process )
side/NN project/NN are/VBP a/DT type/NN of/IN project/NN ./. <EOS>/<EOS>	side project := project <EOS>
task/NN are/VBP part/NN of/IN a/DT project/NN ./. <EOS>/<EOS>	task := E part of . ( project ) <EOS>
every/DT stakeholder/NN is/VBZ involved/VBN in/IN more/JJR than/IN NUM/CD project/NN ./. <EOS>/<EOS>	stakeholder := > NUM involved in . ( project ) <EOS>
every/DT project/NN report/VB to/TO at/IN least/JJS NUM/CD and/CC at/IN most/JJS NUM/CD stakeholder/NN ./. <EOS>/<EOS>	project := ( >= NUM && <= NUM ) report to . ( stakeholder ) <EOS>
each/DT project/NN have/VB a/DT leader/NN ./. <EOS>/<EOS>	project := E have leader . ( T ) <EOS>
positron/NN are/VBP beta/JJ particle/NN ./. <EOS>/<EOS>	positron := beta particle <EOS>
fermion/NN are/VBP part/NN of/IN complex/JJ particle/NN ./. <EOS>/<EOS>	fermion := E part of . ( complex particle ) <EOS>
lepton/NN are/VBP fermion/NN ./. <EOS>/<EOS>	lepton := fermion <EOS>
lepton/NN are/VBP subatomic/JJ particle/NN ./. <EOS>/<EOS>	lepton := subatomic particle <EOS>
boson/NN are/VBP subatomic/JJ particle/NN ./. <EOS>/<EOS>	boson := subatomic particle <EOS>
the/DT manganese/NN atom/NN is/VBZ a/DT atom/NN ./. <EOS>/<EOS>	manganese atom := atom <EOS>
a/DT carbon/NN atom/NN is/VBZ also/RB a/DT atom/NN ./. <EOS>/<EOS>	carbon atom := atom <EOS>
the/DT gadolinium/NN atom/NN is/VBZ a/DT atom/NN ./. <EOS>/<EOS>	gadolinium atom := atom <EOS>
the/DT ununpentium/NN atom/NN is/VBZ a/DT atom/NN ./. <EOS>/<EOS>	ununpentium atom := atom <EOS>
nickel/NN atom/NN is/VBZ a/DT atom/NN ./. <EOS>/<EOS>	nickel atom := atom <EOS>
the/DT magnesium/NN atom/NN is/VBZ a/DT atom/NN ./. <EOS>/<EOS>	magnesium atom := atom <EOS>
rubidium/NN atom/NN are/VBP also/RB atom/NN ./. <EOS>/<EOS>	rubidium atom := atom <EOS>
the/DT rhenium/NN atom/NN is/VBZ a/DT atom/NN ./. <EOS>/<EOS>	rhenium atom := atom <EOS>
carbon/NN atom/NN are/VBP a/DT type/NN of/IN atom/NN ./. <EOS>/<EOS>	carbon atom := atom <EOS>
the/DT unununium/NN atom/NN is/VBZ a/DT atom/NN ./. <EOS>/<EOS>	unununium atom := atom <EOS>
the/DT ununhexium/NN atom/NN is/VBZ a/DT atom/NN ./. <EOS>/<EOS>	ununhexium atom := atom <EOS>
the/DT neodymium/NN atom/NN is/VBZ a/DT atom/NN ./. <EOS>/<EOS>	neodymium atom := atom <EOS>
the/DT lanthanum/NN atom/NN is/VBZ a/DT atom/NN ./. <EOS>/<EOS>	lanthanum atom := atom <EOS>
the/DT argon/NN atom/NN are/VBP a/DT type/NN of/IN atom/NN ./. <EOS>/<EOS>	argon atom := atom <EOS>
the/DT thallium/NN atom/NN is/VBZ also/RB a/DT atom/NN ./. <EOS>/<EOS>	thallium atom := atom <EOS>
the/DT barium/NN atom/NN is/VBZ a/DT atom/NN ./. <EOS>/<EOS>	barium atom := atom <EOS>
the/DT zirconium/NN atom/NN is/VBZ a/DT atom/NN ./. <EOS>/<EOS>	zirconium atom := atom <EOS>
the/DT berkelium/NN atom/NN are/VBP also/RB atom/NN ./. <EOS>/<EOS>	berkelium atom := atom <EOS>
the/DT strontium/NN atom/NN is/VBZ a/DT atom/NN ./. <EOS>/<EOS>	strontium atom := atom <EOS>
the/DT selenium/NN atom/NN is/VBZ a/DT atom/NN ./. <EOS>/<EOS>	selenium atom := atom <EOS>
the/DT carbon/NN atom/NN have/VB NUM/CB proton/NN ./. <EOS>/<EOS>	carbon atom = NUM have proton . ( T ) <EOS>
the/DT xenon/NN atom/NN have/VB NUM/CB proton/NN ./. <EOS>/<EOS>	xenon atom = NUM have proton . ( T ) <EOS>
the/DT silicon/NN atom/NN have/VB NUM/CB proton/NN ./. <EOS>/<EOS>	silicon atom = NUM have proton . ( T ) <EOS>
the/DT nickel/NN atom/NN have/VB NUM/CB proton/NN ./. <EOS>/<EOS>	nickel atom = NUM have proton . ( T ) <EOS>
the/DT neon/NN atom/NN have/VB NUM/CB proton/NN ./. <EOS>/<EOS>	neon atom = NUM have proton . ( T ) <EOS>
a/DT rhodium/NN atom/NN have/VB NUM/CB proton/NN ./. <EOS>/<EOS>	rhodium atom = NUM have proton . ( T ) <EOS>
a/DT arsenic/NN atom/NN have/VB NUM/CB proton/NN ./. <EOS>/<EOS>	arsenic atom = NUM have proton . ( T ) <EOS>
a/DT chlorine/NN atom/NN have/VB NUM/CB proton/NN ./. <EOS>/<EOS>	chlorine atom = NUM have proton . ( T ) <EOS>
a/DT manganese/NN atom/NN have/VB NUM/CB proton/NN ./. <EOS>/<EOS>	manganese atom = NUM have proton . ( T ) <EOS>
all/DT oxygen/NN atom/NN have/VB NUM/CB proton/NN ./. <EOS>/<EOS>	oxygen atom = NUM have proton . ( T ) <EOS>
all/DT thallium/NN atom/NN have/VB NUM/CB proton/NN ./. <EOS>/<EOS>	thallium atom = NUM have proton . ( T ) <EOS>
all/DT antimony/NN atom/NN have/VB NUM/CB proton/NN ./. <EOS>/<EOS>	antimony atom = NUM have proton . ( T ) <EOS>
all/DT germanium/NN atom/NN have/VB NUM/CB proton/NN ./. <EOS>/<EOS>	germanium atom = NUM have proton . ( T ) <EOS>
all/DT scandium/NN atom/NN have/VB NUM/CB proton/NN ./. <EOS>/<EOS>	scandium atom = NUM have proton . ( T ) <EOS>
all/DT chromium/NN atom/NN have/VB NUM/CB proton/NN ./. <EOS>/<EOS>	chromium atom = NUM have proton . ( T ) <EOS>
molybdenum/NN atom/NN have/VB NUM/CB proton/NN ./. <EOS>/<EOS>	molybdenum atom = NUM have proton . ( T ) <EOS>
phosphorus/NN atom/NN have/VB NUM/CB proton/NN ./. <EOS>/<EOS>	phosphorus atom = NUM have proton . ( T ) <EOS>
iodine/NN atom/NN have/VB NUM/CB proton/NN ./. <EOS>/<EOS>	iodine atom = NUM have proton . ( T ) <EOS>
gallium/NN atom/NN have/VB NUM/CB proton/NN ./. <EOS>/<EOS>	gallium atom = NUM have proton . ( T ) <EOS>
radium/NN atom/NN have/VB NUM/CB proton/NN ./. <EOS>/<EOS>	radium atom = NUM have proton . ( T ) <EOS>
carnivor/NN are/VBP a/DT type/NN of/IN animal/NN ./. <EOS>/<EOS>	carnivor := animal <EOS>
carnivor/NN are/VBP also/RB animal/NN that/WDT eat/VBZ only/RB animal/NN ./. <EOS>/<EOS>	carnivor := animal ^ A eat . ( animal ) <EOS>
herbivor/NN are/VBP animal/NN ./. <EOS>/<EOS>	herbivor := animal <EOS>
a/DT herbivor/NN is/VBZ a/DT animal/NN that/WDT eat/VBZ only/RB plant/NN ./. <EOS>/<EOS>	herbivor := animal ^ A eat . ( plant ) <EOS>
every/DT herbivor/NN is/VBZ also/RB a/DT animal/NN that/WDT eat/VBZ only/RB plant/NN ./. <EOS>/<EOS>	herbivor := animal ^ A eat . ( plant ) <EOS>
every/DT mammal/NN is/VBZ also/RB a/DT animal/NN ./. <EOS>/<EOS>	mammal := animal <EOS>
every/DT mammal/NN is/VBZ also/RB a/DT animal/NN that/WDT brestfeed/VB puppy/NN ./. <EOS>/<EOS>	mammal := animal ^ E brestfeed . ( puppy ) <EOS>
mammal/NN are/VBP also/RB animal/NN that/WDT brestfeed/VB puppy/NN ./. <EOS>/<EOS>	mammal := animal ^ E brestfeed . ( puppy ) <EOS>
all/DT mammal/NN are/VBP animal/NN that/WDT brestfeed/VB puppy/NN ./. <EOS>/<EOS>	mammal := animal ^ E brestfeed . ( puppy ) <EOS>
all/DT insect/NN are/VBP also/RB small/JJ animal/NN ./. <EOS>/<EOS>	insect := small animal <EOS>
every/DT dolphin/NN is/VBZ also/RB a/DT acquatic/JJ mammal/NN ./. <EOS>/<EOS>	dolphin := acquatic mammal <EOS>
dolphin/NN are/VBP acquatic/JJ mammal/NN that/WDT live/VB in/IN the/DT sea/NN ./. <EOS>/<EOS>	dolphin := acquatic mammal ^ E live in . ( sea ) <EOS>
all/DT dolphin/NN are/VBP acquatic/JJ mammal/NN that/DT have/VB a/DT long/JJ muzzle/NN ./. <EOS>/<EOS>	dolphin := acquatic mammal ^ have long muzzle . ( T ) <EOS>
cow/NN are/VBP also/RB herbivor/NN ./. <EOS>/<EOS>	cow := herbivor <EOS>
cow/NN are/VBP also/RB herbivor/NN that/WDT produce/VB milk/NN ./. <EOS>/<EOS>	cow := herbivor ^ E produce . ( milk ) <EOS>
cow/NN are/VBP mammal/NN ./. <EOS>/<EOS>	cow := mammal <EOS>
every/DT cow/NN is/VBZ a/DT mammal/NN that/DT have/VB NUM/CD long/JJ horn/NN ./. <EOS>/<EOS>	cow := mammal ^ = NUM have long horn . ( T ) <EOS>
cow/NN are/VBP also/RB mammal/NN that/DT have/VB NUM/CD long/JJ horn/NN ./. <EOS>/<EOS>	cow := mammal ^ = NUM have long horn . ( T ) <EOS>
lion/NN are/VBP a/DT type/NN of/IN carnivor/NN ./. <EOS>/<EOS>	lion := carnivor <EOS>
every/DT lion/NN is/VBZ a/DT carnivor/NN that/WDT live/VB in/IN africa/NN ./. <EOS>/<EOS>	lion := carnivor ^ E live in . ( africa ) <EOS>
lion/NN are/VBP also/RB carnivor/NN that/WDT live/VB in/IN africa/NN ./. <EOS>/<EOS>	lion := carnivor ^ E live in . ( africa ) <EOS>
every/DT lion/NN is/VBZ also/RB a/DT carnivor/NN that/WDT hunt/VB the/DT gazelle/NN ./. <EOS>/<EOS>	lion := carnivor ^ E hunt . ( gazelle ) <EOS>
lion/NN are/VBP also/RB carnivor/NN that/WDT hunt/VB gazelle/NN ./. <EOS>/<EOS>	lion := carnivor ^ E hunt . ( gazelle ) <EOS>
all/DT lion/NN are/VBP also/RB carnivor/NN that/WDT hunt/VB the/DT gazelle/NN ./. <EOS>/<EOS>	lion := carnivor ^ E hunt . ( gazelle ) <EOS>
all/DT lion/NN are/VBP mammal/NN ./. <EOS>/<EOS>	lion := mammal <EOS>
all/DT lion/NN are/VBP also/RB mammal/NN that/DT have/VB long/JJ hair/NN ./. <EOS>/<EOS>	lion := mammal ^ have long hair . ( T ) <EOS>
every/DT lion/NN is/VBZ a/DT mammal/NN that/DT have/VB a/DT long/JJ hair/NN ./. <EOS>/<EOS>	lion := mammal ^ have long hair . ( T ) <EOS>
lion/NN are/VBP mammal/NN that/DT have/VB a/DT long/JJ hair/NN ./. <EOS>/<EOS>	lion := mammal ^ have long hair . ( T ) <EOS>
the/DT male/JJ lion/NN have/VB more/JJR than/IN NUM/CD female/JJ mate/NN ./. <EOS>/<EOS>	male lion := >= NUM have female mate . ( T ) <EOS>
theE/DT male/JJ lion/NN have/VB at/IN least/JJS NUM/CD female/JJ mate/NN ./. <EOS>/<EOS>	male lion := >= NUM have female mate . ( T ) <EOS>
the/DT male/JJ lion/NN have/VB not/RB less/JJR than/IN NUM/CD female/JJ mate/NN ./. <EOS>/<EOS>	male lion := >= NUM have female mate . ( T ) <EOS>
a/DT male/JJ lion/NN have/VB not/RB less/JJR than/IN NUM/CD female/JJ mate/NN ./. <EOS>/<EOS>	male lion := >= NUM have female mate . ( T ) <EOS>
male/JJ lion/NN have/VB not/RB less/JJR than/IN NUM/CD female/JJ mate/NN ./. <EOS>/<EOS>	male lion := >= NUM have female mate . ( T ) <EOS>
tiger/NN are/VBP carnivor/NN ./. <EOS>/<EOS>	tiger := carnivor <EOS>
all/DT tiger/NN are/VBP carnivor/NN that/WDT live/VB in/IN asia/NN ./. <EOS>/<EOS>	tiger := carnivor ^ E live in . ( asia ) <EOS>
every/DT tiger/NN is/VBZ also/RB a/DT mammal/NN ./. <EOS>/<EOS>	tiger := mammal <EOS>
every/DT tiger/NN is/VBZ also/RB a/DT large/JJ feline/NN that/DT have/VB black/JJ stripe/NN ./. <EOS>/<EOS>	tiger := large feline ^ E have black stripe . ( T ) <EOS>
tiger/NN are/VBP a/DT type/NN of/IN large/JJ feline/NN that/DT have/VB black/JJ stripe/NN ./. <EOS>/<EOS>	tiger := large feline ^ E have black stripe . ( T ) <EOS>
female/JJ tiger/NN have/VB at/IN most/JJS NUM/CD male/JJ mate/NN ./. <EOS>/<EOS>	female tiger := <= NUM have male mate . ( T ) <EOS>
female/JJ tiger/NN have/VB at/IN most/JJS NUM/CD male/JJ mate/NN ./. <EOS>/<EOS>	female tiger := <= NUM have male mate . ( T ) <EOS>
gazelle/NN are/VBP also/RB herbivor/NN ./. <EOS>/<EOS>	gazelle := herbivor <EOS>
every/DT gazelle/NN is/VBZ also/RB a/DT fast/JJ herbivor/NN that/WDT live/VB in/IN africa/NN ./. <EOS>/<EOS>	gazelle := fast herbivor ^ E live in . ( africa ) <EOS>
all/DT gazelle/NN are/VBP also/RB fast/JJ herbivor/NN that/WDT live/VB in/IN africa/NN ./. <EOS>/<EOS>	gazelle := fast herbivor ^ E live in . ( africa ) <EOS>
every/DT gazelle/NN is/VBZ also/RB a/DT mammal/NN that/WDT is/VBZ chased/VBD by/IN lion/NN ./. <EOS>/<EOS>	gazelle := mammal ^ E chased by . ( lion ) <EOS>
all/DT gazelle/NN are/VBP mammal/NN that/WDT are/VBD chased/VBD by/IN lion/NN ./. <EOS>/<EOS>	gazelle := mammal ^ E chased by . ( lion ) <EOS>
gazelle/NN are/VBP mammal/NN that/WDT are/VBD chased/VBD by/IN the/DT lion/NN ./. <EOS>/<EOS>	gazelle := mammal ^ E chased by . ( lion ) <EOS>
gazelle/NN are/VBP also/RB mammal/NN that/WDT are/VBD chased/VBD by/IN the/DT lion/NN ./. <EOS>/<EOS>	gazelle := mammal ^ E chased by . ( lion ) <EOS>
giraffe/NN are/VBP also/RB herbivor/NN ./. <EOS>/<EOS>	giraffe := herbivor <EOS>
all/DT giraffe/NN are/VBP herbivor/NN that/WDT live/VB in/IN africa/NN ./. <EOS>/<EOS>	giraffe := herbivor ^ E live in . ( africa ) <EOS>
every/DT giraffe/NN is/VBZ also/RB a/DT mammal/NN that/DT have/VB a/DT long/JJ neck/NN ./. <EOS>/<EOS>	giraffe := mammal ^ have long neck . ( T ) <EOS>
giraffe/NN are/VBP a/DT type/NN of/IN mammal/NN that/DT have/VB a/DT long/JJ neck/NN ./. <EOS>/<EOS>	giraffe := mammal ^ have long neck . ( T ) <EOS>
all/DT pachyderm/NN are/VBP also/RB large/JJ animal/NN ./. <EOS>/<EOS>	pachyderm := large animal <EOS>
all/DT elephant/NN are/VBP pachyderm/NN ./. <EOS>/<EOS>	elephant := pachyderm <EOS>
a/DT elephant/NN is/VBZ a/DT pachyderm/NN that/WDT live/VB in/IN africa/NN or/CC asia/NN ./. <EOS>/<EOS>	elephant := pachyderm ^ E live in . ( africa U asia ) <EOS>
every/DT elephant/NN is/VBZ a/DT pachyderm/NN that/WDT live/VB in/IN africa/NN or/CC asia/NN ./. <EOS>/<EOS>	elephant := pachyderm ^ E live in . ( africa U asia ) <EOS>
elephant/NN are/VBP mammal/NN that/DT have/VB big/JJ trunk/NN ./. <EOS>/<EOS>	elephant := mammal ^ have big trunk . ( T ) <EOS>
a/DT elephant/NN is/VBZ also/RB a/DT mammal/NN that/DT have/VB a/DT big/JJ trunk/NN ./. <EOS>/<EOS>	elephant := mammal ^ have big trunk . ( T ) <EOS>
elephant/NN are/VBP also/RB mammal/NN that/DT have/VB a/DT big/JJ trunk/NN ./. <EOS>/<EOS>	elephant := mammal ^ have big trunk . ( T ) <EOS>
elephant/NN are/VBP pachyderm/NN that/DT have/VB exactly/RB NUM/CD large/JJ ear/NN ./. <EOS>/<EOS>	elephant := pachyderm ^ = NUM have large ear . ( T ) <EOS>
all/DT elephant/NN are/VBP also/RB pachyderm/NN that/DT have/VB exactly/RB NUM/CD large/JJ ear/NN ./. <EOS>/<EOS>	elephant := pachyderm ^ = NUM have large ear . ( T ) <EOS>
every/DT elephant/NN is/VBZ also/RB a/DT pachyderm/NN that/DT have/VB NUM/CD large/JJ ear/NN ./. <EOS>/<EOS>	elephant := pachyderm ^ = NUM have large ear . ( T ) <EOS>
all/DT elephant/NN are/VBP pachyderm/NN that/DT have/VB NUM/CD large/JJ ear/NN ./. <EOS>/<EOS>	elephant := pachyderm ^ = NUM have large ear . ( T ) <EOS>
rhinoceros/NN are/VBP a/DT type/NN of/IN pachyderm/NN ./. <EOS>/<EOS>	rhinoceros := pachyderm <EOS>
rhinoceros/NN are/VBP also/RB pachyderm/NN that/WDT live/VB in/IN africa/NN ./. <EOS>/<EOS>	rhinoceros := pachyderm ^ E live in . ( africa ) <EOS>
all/DT rhinoceros/NN are/VBP pachyderm/NN that/WDT live/VB in/IN africa/NN ./. <EOS>/<EOS>	rhinoceros := pachyderm ^ E live in . ( africa ) <EOS>
a/DT rhinoceros/NN is/VBZ a/DT mammal/NN that/DT have/VB exactly/RB NUM/CD horn/NN ./. <EOS>/<EOS>	rhinoceros := mammal ^ = NUM have horn . ( T ) <EOS>
every/DT rhinoceros/NN is/VBZ a/DT mammal/NN that/DT have/VB exactly/RB NUM/CD horn/NN ./. <EOS>/<EOS>	rhinoceros := mammal ^ = NUM have horn . ( T ) <EOS>
every/DT rhinoceros/NN is/VBZ also/RB a/DT mammal/NN that/DT have/VB exactly/RB NUM/CD horn/NN ./. <EOS>/<EOS>	rhinoceros := mammal ^ = NUM have horn . ( T ) <EOS>
rhinoceros/NN are/VBP a/DT type/NN of/IN mammal/NN that/DT have/VB NUM/CD horn/NN ./. <EOS>/<EOS>	rhinoceros := mammal ^ = NUM have horn . ( T ) <EOS>
a/DT cat/NN is/VBZ a/DT animal/NN that/WDT is/VBZ chased/VBD by/IN dog/NN ./. <EOS>/<EOS>	cat := animal ^ E chased by . ( dog ) <EOS>
a/DT cat/NN is/VBZ also/RB a/DT animal/NN that/WDT is/VBZ chased/VBD by/IN dog/NN ./. <EOS>/<EOS>	cat := animal ^ E chased by . ( dog ) <EOS>
a/DT cat/NN is/VBZ also/RB a/DT animal/NN that/WDT is/VBZ chased/VBD by/IN the/DT dog/NN ./. <EOS>/<EOS>	cat := animal ^ E chased by . ( dog ) <EOS>
all/DT cat/NN are/VBP animal/NN that/WDT are/VBD chased/VBD by/IN dog/NN ./. <EOS>/<EOS>	cat := animal ^ E chased by . ( dog ) <EOS>
cat/NN are/VBP also/RB animal/NN that/WDT are/VBD chased/VBD by/IN a/DT dog/NN ./. <EOS>/<EOS>	cat := animal ^ E chased by . ( dog ) <EOS>
all/DT cat/NN are/VBP mammal/NN that/WDT chase/VB mouse/NN ./. <EOS>/<EOS>	cat := mammal ^ E chase . ( mouse ) <EOS>
all/DT cat/NN are/VBP also/RB mammal/NN that/WDT chase/VB mouse/NN ./. <EOS>/<EOS>	cat := mammal ^ E chase . ( mouse ) <EOS>
cat/NN are/VBP a/DT type/NN of/IN mammal/NN that/WDT chase/VB a/DT mouse/NN ./. <EOS>/<EOS>	cat := mammal ^ E chase . ( mouse ) <EOS>
cat/NN are/VBP also/RB mammal/NN that/WDT chase/VB the/DT mouse/NN ./. <EOS>/<EOS>	cat := mammal ^ E chase . ( mouse ) <EOS>
cat/NN are/VBP a/DT type/NN of/IN mammal/NN that/WDT chase/VB the/DT mouse/NN ./. <EOS>/<EOS>	cat := mammal ^ E chase . ( mouse ) <EOS>
dog/NN are/VBP a/DT type/NN of/IN animal/NN ./. <EOS>/<EOS>	dog := animal <EOS>
all/DT mouse/NN are/VBP also/RB small/JJ animal/NN ./. <EOS>/<EOS>	mouse := small animal <EOS>
a/DT mouse/NN is/VBZ a/DT animal/NN that/WDT is/VBZ chased/VBD only/RB by/IN cat/NN ./. <EOS>/<EOS>	mouse := animal ^ A chased by . ( cat ) <EOS>
every/DT mouse/NN is/VBZ also/RB a/DT animal/NN that/WDT is/VBZ chased/VBD only/RB by/IN cat/NN ./. <EOS>/<EOS>	mouse := animal ^ A chased by . ( cat ) <EOS>
every/DT mouse/NN is/VBZ also/RB a/DT animal/NN that/WDT is/VBZ chased/VBD only/RB by/IN the/DT cat/NN ./. <EOS>/<EOS>	mouse := animal ^ A chased by . ( cat ) <EOS>
mouse/NN are/VBP also/RB animal/NN that/WDT are/VBD chased/VBD only/RB by/IN cat/NN ./. <EOS>/<EOS>	mouse := animal ^ A chased by . ( cat ) <EOS>
all/DT mouse/NN are/VBP also/RB animal/NN that/WDT are/VBD chased/VBD only/RB by/IN the/DT cat/NN ./. <EOS>/<EOS>	mouse := animal ^ A chased by . ( cat ) <EOS>
a/DT bee/NN is/VBZ also/RB a/DT insect/NN that/WDT produce/VB honey/NN ./. <EOS>/<EOS>	bee := insect ^ E produce . ( honey ) <EOS>
bee/NN are/VBP also/RB insect/NN that/WDT live/VB in/IN hive/NN ./. <EOS>/<EOS>	bee := insect ^ E live in . ( hive ) <EOS>
bee/NN are/VBP insect/NN that/WDT live/VB in/IN the/DT hive/NN ./. <EOS>/<EOS>	bee := insect ^ E live in . ( hive ) <EOS>
bee/NN are/VBP also/RB insect/NN that/WDT live/VB in/IN the/DT hive/NN ./. <EOS>/<EOS>	bee := insect ^ E live in . ( hive ) <EOS>
all/DT bee/NN are/VBP also/RB insect/NN that/DT have/VB NUM/CD leg/NN ./. <EOS>/<EOS>	bee := insect ^ = NUM have leg . ( T ) <EOS>
a/DT bee/NN have/VB black/JJ stripe/NN ./. <EOS>/<EOS>	bee := E have black stripe . ( T ) <EOS>
vehicle/NN are/VBP mean/NN of/IN transportation/NN ./. <EOS>/<EOS>	vehicle := mean of transportation <EOS>
every/DT bycicle/NN is/VBZ a/DT vehicle/NN ./. <EOS>/<EOS>	bycicle := vehicle <EOS>
bycicle/NN are/VBP a/DT type/NN of/IN vehicle/NN that/DT have/VB NUM/CD weel/NN ./. <EOS>/<EOS>	bycicle := vehicle ^ = NUM have weel . ( T ) <EOS>
a/DT bycicle/NN is/VBZ a/DT mean/NN of/IN transportation/NN that/WDT is/VBZ powered/VBD only/RB by/IN the/DT human/JJ power/NN ./. <EOS>/<EOS>	bycicle := mean of transportation ^ A powered by . ( human power ) <EOS>
bycicle/NN are/VBP mean/NN of/IN transportation/NN that/WDT are/VBP powered/VBD only/RB by/IN human/JJ power/NN ./. <EOS>/<EOS>	bycicle := mean of transportation ^ A powered by . ( human power ) <EOS>
bycicle/NN are/VBP a/DT type/NN of/IN mean/NN of/IN transportation/NN that/WDT are/VBP powered/VBD only/RB by/IN human/JJ power/NN ./. <EOS>/<EOS>	bycicle := mean of transportation ^ A powered by . ( human power ) <EOS>
all/DT bycicle/NN are/VBP mean/NN of/IN transportation/NN that/WDT are/VBP powered/VBD only/RB by/IN the/DT human/JJ power/NN ./. <EOS>/<EOS>	bycicle := mean of transportation ^ A powered by . ( human power ) <EOS>
weel/NN are/VBP part/NN of/IN the/DT bycicle/NN ./. <EOS>/<EOS>	weel := E part of . ( bycicle ) <EOS>
frame/NN are/VBP part/NN of/IN the/DT bycicle/NN ./. <EOS>/<EOS>	frame := E part of . ( bycicle ) <EOS>
handle/NN bar/NN are/VBP part/NN of/IN bycicle/NN ./. <EOS>/<EOS>	handle bar := E part of . ( bycicle ) <EOS>
car/NN are/VBP vehicle/NN ./. <EOS>/<EOS>	car := vehicle <EOS>
car/NN are/VBP mean/NN of/IN transportation/NN that/WDT are/VBP powered/VBD by/IN fuel/NN or/CC electric/JJ energy/NN ./. <EOS>/<EOS>	car := mean of transportation ^ E powered by . ( fuel U electric energy ) <EOS>
a/DT engine/NN is/VBZ also/DT a/DT complex/JJ system/NN that/DT is/VBZ part/NN of/IN car/NN ./. <EOS>/<EOS>	engine := complex system ^ E part of . ( car ) <EOS>
a/DT engine/NN is/VBZ a/DT complex/JJ system/NN that/DT is/VBZ part/NN of/IN a/DT car/NN ./. <EOS>/<EOS>	engine := complex system ^ E part of . ( car ) <EOS>
engine/NN are/VBP complex/JJ system/NN that/DT are/VBP part/NN of/IN a/DT car/NN ./. <EOS>/<EOS>	engine := complex system ^ E part of . ( car ) <EOS>
engine/NN are/VBP complex/JJ system/NN that/DT are/VBP part/NN of/IN the/DT car/NN ./. <EOS>/<EOS>	engine := complex system ^ E part of . ( car ) <EOS>
engine/NN are/VBP also/DT complex/JJ system/NN that/DT are/VBP part/NN of/IN the/DT car/NN ./. <EOS>/<EOS>	engine := complex system ^ E part of . ( car ) <EOS>
all/DT engine/NN are/VBP complex/JJ system/NN that/DT are/VBP part/NN of/IN the/DT car/NN ./. <EOS>/<EOS>	engine := complex system ^ E part of . ( car ) <EOS>
gear/NN are/VBP part/NN of/IN engine/NN ./. <EOS>/<EOS>	gear := E part of . ( engine ) <EOS>
steering/VBG weel/NN are/VBP part/NN of/IN car/NN ./. <EOS>/<EOS>	steering weel := E part of . ( car ) <EOS>
motorcycle/NN are/VBP vehicle/NN ./. <EOS>/<EOS>	motorcycle := vehicle <EOS>
weel/NN are/VBP part/NN of/IN the/DT motorcycle/NN ./. <EOS>/<EOS>	weel := E part of . ( motorcycle ) <EOS>
engine/NN are/VBP also/DT complex/JJ energy/NN production/NN system/NN that/DT are/VBP part/NN of/IN motorcycle/NN ./. <EOS>/<EOS>	engine := complex energy production system ^ E part of . ( motorcycle ) <EOS>
a/DT engine/NN is/VBZ a/DT complex/JJ energy/NN production/NN system/NN that/DT is/VBZ part/NN of/IN a/DT motorcycle/NN ./. <EOS>/<EOS>	engine := complex energy production system ^ E part of . ( motorcycle ) <EOS>
every/DT engine/NN is/VBZ also/DT a/DT complex/JJ energy/NN production/NN system/NN that/DT is/VBZ part/NN of/IN a/DT motorcycle/NN ./. <EOS>/<EOS>	engine := complex energy production system ^ E part of . ( motorcycle ) <EOS>
engine/NN are/VBP complex/JJ energy/NN production/NN system/NN that/DT are/VBP part/NN of/IN a/DT motorcycle/NN ./. <EOS>/<EOS>	engine := complex energy production system ^ E part of . ( motorcycle ) <EOS>
all/DT engine/NN are/VBP also/DT complex/JJ energy/NN production/NN system/NN that/DT are/VBP part/NN of/IN a/DT motorcycle/NN ./. <EOS>/<EOS>	engine := complex energy production system ^ E part of . ( motorcycle ) <EOS>
saddle/NN are/VBP part/NN of/IN the/DT motorcycle/NN ./. <EOS>/<EOS>	saddle := E part of . ( motorcycle ) <EOS>
frame/NN are/VBP part/NN of/IN motorcycle/NN ./. <EOS>/<EOS>	frame := E part of . ( motorcycle ) <EOS>
handle/NN bar/NN are/VBP part/NN of/IN the/DT bycicle/NN ./. <EOS>/<EOS>	handle bar := E part of . ( bycicle ) <EOS>
all/DT engine/NN are/VBP also/RB energy/NN production/NN system/NN ./. <EOS>/<EOS>	engine := energy production system <EOS>
engine/NN are/VBP also/RB energy/NN production/NN system/NN ./. <EOS>/<EOS>	engine := energy production system <EOS>
a/DT engine/NN is/VBZ a/DT complex/JJ system/NN that/WDT produce/VB energy/NN ./. <EOS>/<EOS>	engine := complex system ^ E produce . ( energy ) <EOS>
engine/NN are/VBP also/RB complex/JJ system/NN that/WDT produce/VB energy/NN ./. <EOS>/<EOS>	engine := complex system ^ E produce . ( energy ) <EOS>
every/DT hammer/NN is/VBZ also/RB a/DT tool/NN ./. <EOS>/<EOS>	hammer := tool <EOS>
a/DT screwdriver/NN is/VBZ also/RB a/DT tool/NN that/WDT handle/NN screw/NN ./. <EOS>/<EOS>	screwdriver := tool ^ E handle . ( screw ) <EOS>
screwdriver/NN are/VBP also/RB tool/NN that/WDT handle/NN screw/NN ./. <EOS>/<EOS>	screwdriver := tool ^ E handle . ( screw ) <EOS>
all/DT flat/JJ blade/NN screwdriver/NN are/VBP screwdriver/NN that/DT have/VB flat/JJ blade/NN ./. <EOS>/<EOS>	flat blade screwdriver := screwdriver ^ E have flat blade . ( T ) <EOS>
a/DT flat/JJ blade/NN screwdriver/NN is/VBZ a/DT screwdriver/NN that/DT have/VB a/DT flat/JJ blade/NN ./. <EOS>/<EOS>	flat blade screwdriver := screwdriver ^ E have flat blade . ( T ) <EOS>
flat/JJ blade/NN screwdriver/NN are/VBP also/RB screwdriver/NN that/DT have/VB a/DT flat/JJ blade/NN ./. <EOS>/<EOS>	flat blade screwdriver := screwdriver ^ E have flat blade . ( T ) <EOS>
flat/JJ blade/NN screwdriver/NN are/VBP a/DT type/NN of/IN screwdriver/NN that/DT have/VB a/DT flat/JJ blade/NN ./. <EOS>/<EOS>	flat blade screwdriver := screwdriver ^ E have flat blade . ( T ) <EOS>
all/DT cross/NN blade/NN screwdriver/NN are/VBP also/RB screwdriver/NN that/DT have/VB cross/NN blade/NN ./. <EOS>/<EOS>	cross blade screwdriver := screwdriver ^ E have cross blade . ( T ) <EOS>
cross/NN blade/NN screwdriver/NN are/VBP a/DT type/NN of/IN screwdriver/NN that/DT have/VB cross/NN blade/NN ./. <EOS>/<EOS>	cross blade screwdriver := screwdriver ^ E have cross blade . ( T ) <EOS>
every/DT cross/NN blade/NN screwdriver/NN is/VBZ also/RB a/DT screwdriver/NN that/DT have/VB a/DT cross/NN blade/NN ./. <EOS>/<EOS>	cross blade screwdriver := screwdriver ^ E have cross blade . ( T ) <EOS>
a/DT power/NN screwdriver/NN is/VBZ also/RB a/DT screwdriver/NN that/WDT is/VBZ powered/VBD by/IN electric/JJ energy/NN ./. <EOS>/<EOS>	power screwdriver := screwdriver ^ E powered by . ( electric energy ) <EOS>
every/DT power/NN screwdriver/NN is/VBZ a/DT screwdriver/NN that/WDT is/VBZ powered/VBD by/IN electric/JJ energy/NN ./. <EOS>/<EOS>	power screwdriver := screwdriver ^ E powered by . ( electric energy ) <EOS>
a/DT power/NN screwdriver/NN is/VBZ also/RB a/DT screwdriver/NN that/WDT is/VBZ powered/VBD by/IN the/DT electric/JJ energy/NN ./. <EOS>/<EOS>	power screwdriver := screwdriver ^ E powered by . ( electric energy ) <EOS>
all/DT power/NN screwdriver/NN are/VBP also/RB screwdriver/NN that/WDT are/VBP powered/VBD by/IN the/DT electric/JJ energy/NN ./. <EOS>/<EOS>	power screwdriver := screwdriver ^ E powered by . ( electric energy ) <EOS>
all/DT gardern/NN fork/NN are/VBP tool/NN ./. <EOS>/<EOS>	gardern fork := tool <EOS>
all/DT drill/NN are/VBP power/NN tool/NN ./. <EOS>/<EOS>	drill := power tool <EOS>
all/DT power/NN tool/NN are/VBP tool/NN ./. <EOS>/<EOS>	power tool := tool <EOS>
all/DT rake/NN are/VBP also/RB tool/NN ./. <EOS>/<EOS>	rake := tool <EOS>
every/DT saw/NN is/VBZ a/DT tool/NN ./. <EOS>/<EOS>	saw := tool <EOS>
all/DT hand/NN tool/NN are/VBP also/RB tool/NN ./. <EOS>/<EOS>	hand tool := tool <EOS>
clamp/NN are/VBP also/RB tool/NN ./. <EOS>/<EOS>	clamp := tool <EOS>
every/DT clamp/NN is/VBZ a/DT tool/NN that/WDT can/MD secure/VB object/NN ./. <EOS>/<EOS>	clamp := tool ^ >= NUM secure . ( object ) <EOS>
a/DT saw/NN is/VBZ a/DT tool/NN that/DT have/VB a/DT sharp/JJ blade/NN ./. <EOS>/<EOS>	saw := tool ^ E have sharp blade . ( T ) <EOS>
saw/NN can/MD cut/VB wood/NN ./. <EOS>/<EOS>	saw := >= NUM cut . ( wood ) <EOS>
scissor/NN are/VBP manual/JJ tool/NN that/DT cut/VB paper/NN or/CC cardboard/NN ./. <EOS>/<EOS>	scissor := manual tool ^ E cut . ( paper U cardboard ) <EOS>
chainsaw/NN are/VB a/DT type/NN of/IN saw/NN that/DT are/VBP powered/VDB by/IN electric/JJ energy/NN ./. <EOS>/<EOS>	chainsaw := saw ^ E powered by . ( electric energy ) <EOS>
the/DT handle/NN is/VBZ part/NN of/IN the/DT knife/NN ./. <EOS>/<EOS>	handle := E part of . ( knife ) <EOS>
a/DT grind/NN is/VBZ part/NN of/IN the/DT blade/NN ./. <EOS>/<EOS>	grind := E part of . ( blade ) <EOS>
knife/NN have/VB a/DT blade/NN ./. <EOS>/<EOS>	knife := E have blade . ( T ) <EOS>
a/DT rake/NN is/VBZ a/DT tool/NN that/WDT collect/VB dead/JJ leaf/NN ./. <EOS>/<EOS>	rake := tool ^ E collect . ( dead leaf ) <EOS>
rake/NN are/VB tool/NN that/WDT collect/VB dead/JJ leaf/NN ./. <EOS>/<EOS>	rake := tool ^ E collect . ( dead leaf ) <EOS>
rake/NN are/VB used/VBD in/IN farming/VBG activity/NN ./. <EOS>/<EOS>	rake := E used in . ( farming activity ) <EOS>
the/DT pole/NN is/VBZ part/NN of/IN the/DT rake/NN ./. <EOS>/<EOS>	pole := E part of . ( rake ) <EOS>
thoot/NN are/VBP part/NN of/IN the/DT rake/NN ./. <EOS>/<EOS>	thoot := E part of . ( rake ) <EOS>
chainsaw/NN are/VBP used/VBD only/RB by/IN expert/JJ operator/NN ./. <EOS>/<EOS>	chainsaw := A used by . ( expert operator ) <EOS>
ray/NN rake/NN are/VBP tool/NN that/WDT are/VBP used/VBD only/RB by/IN expert/JJ farmer/NN ./. <EOS>/<EOS>	ray rake := tool ^ A used by . ( expert farmer ) <EOS>